24
24
FFFFFFFFFFFFFFFFFFFFFFFF
FBBBBeBBBBBBSBBBBBBBBBBF
FBBBBBBBBBBBBBBBBBTBBBBF
FBBBBBBBBBBBBBBBFFFFFFFF
FBBBBBBBBBBBBBBBFBBBBBBB
FBBBBBBBBBB0BBBBFBBBBBBB
FBBBBBBBBBBBBBEBFBBBBBBB
FBBBBBFFFFFFFFFFFFFFFFFF
FBBBFFFBBBBBBBBBBBBBBBBF
FFBBBBBBBBBBBBBBBBBBBBBF
BFFBBBBBBBBBBgBBBBBBBBBF
BBFFFFBBBBGBFFFFFBBBBBBF
BBBBBFBBBBBBBBBBFFFBBBBF
BBBBBFBBBBBBBBBBBBBBBBFF
BBBBBFBBBBBBBBHBBBBBFFFB
FFFFFFFFFhBBBBBBBBFFFBBB
FBBBBBBCBBBBBBBBFFFBBBBB
FB1B0BBCBBBBBBFFFBBBBBBB
FBBBBBBCBBBBFFFBBBBBBBBB
FFFFFBFFFBFFFBBBBBBBBBBB
BBBFBBBFBBBFBBBBBBBBBBBB
BBBFBBBFBBBFBBBBBBBBBBBB
BBBFBBBBBBBFBBBBBBBBBBBB
BBBFFFFFFFFFBBBBBBBBBBBB