9
9
FFFFFFFFF
FBBeBBSBF
FBBBBBTBF
FBBBBFFFF
FBBBBVBBF
FBsBBBBBF
FFFFFF0BF
FBBEBBBBF
FFFFFFFFF