140
39
FFFFFFNNNNNNNNNNNNNNNNNNNNNNNNNNNNNNNNNNNNNNNNNNNNNNNNNNNNNNNNNNNNNNNNNNNNNNNNNNNNNNNNNNNNNNNNNNNNNNNNNNNNNNNNNNNNNNNNNNNNNNNNNNNNNNNNNNNNNN
NF                                                                                            v                      y                FFFFFF
NF                         Y                                     u                           FFF                    FFF                    F
NF                                                              FFF                       F   F                      F                     F
NF   AS                                        j         f       F                               F                                     B   F
NFFFFFFFFFF                                        T  FFFFF  T   T                                                                       s F
N   FF  e                                l            e F i                                                                           FFFFFF
FFFFFF                                     C            F                                                                               e  N
F                                          C            F           J                                                     FFFF             N
F0  1                                      C  C         F                                                         c        FF     W        N
F                                             C         F                                                        FFF                       N
F                                             C         FFFFF           j         U                               F                        N
FFFFFF                                        C         FF                                                                                 N
F            FFF     R                    C   C         FF                                                           F                     N
F             F                           C   C         FF       l               L                                                         N
F   B                                     C   C         F g                                                                                N
F q                                    C  C             FFFFF                                                                              N
FFFFFF                                 C                F                 l                                 V          F               FFFFF
F                                      C                F                                            F                                    FF
F                                      C                F                                                                                 FF
F  r                                                    F         j                                                                       FF
FFFFFF                                                  F                                              FFF          F                    g F
N   d                                     C             F                                               F                              FFFFF
N                                         C             F              j                                                F                  N
N                                         C           t F                          b                F                                      N
FFFFF                                     C          FFFF                         FFF                                                      N
FF                                        C             F                          F                                   x                   N
FF                                                      F                                                            FFFFFC                N
FF                                              b       F                                              F               F  C                N
F g                                   FFFFFFFFFFFFFFFC  F                                                                 C                N
FFFFF                                   d  e FF   i  C  F                                                                 C                N
N                                            FF      C  Fn     b                                    F                     C                N
N               Q                            FF      C  FF    FFF      f                                                                   N
N   c                                        FF                F    FFFFF                                                      X   w       N
NFFFFF                           FFFFF       FF                F      F      FFF               V      c                         FFFFFF     N
N  F                       Q      FFF        FF       FFFFF F  F              F    FFF              FFFF       F         F        FF       N
N                    R                       FF         F e    F          c         F    b           FF    F        F       F  F           N
N          R                                 FF         F      F      FFFFFF            FFFFF          FFFF   F                            N
NNNNNNQNNNNNNNNNNNNNNNNNNNNNNNNNNNNNNNNNNNNNNFFNNNNNNNNNFNNNNNNFNNNNNNNNFFNNNNNNNNNNNNNNNNFNNNNNNNNNNNNNFFNNNNNNNNNNNNNFFFFNNNNNNNNNNNNNNNNN