250
30
FFFFFFFFFFFFFFF                                                                                                                                                                                                                                           
F     e d   q                                                                                                                                                                                                                                             
F                                                                                                                                                                                                                                                         
F                                                                                                                                                                                                                                                         
F                                                                                                                                                                                                                                                         
F                                                                                                                                                                                                                                                         
F                                                                                                                                                                                                                                                         
F                                                                                        c     c                                                                                                                                                         F
F                                                                                FFFFFFFFFFFFFFFFFF                                                                                                                                                      F
F                                                                               F                  F                                                                                                                                                     F
F                                                                            FFF                    FFF                                                                                                                                                  F
F                                                                        FFFF d                                                                                                                                                                          F
F                                                                       FFFF        g   t       n     S                                                                                                                                                  F
F                                                                     FFFFFFFFFFFFFFFFFFFFFFFFFFFFFFFFFFFFFF                                                                                                      FFU  FF    G                           F
F                                                                    FFFFFFFFFFFFFFFFFFFFFFFFFFFFFFFFFFFFFFFFFF                                                                                               FFFFFF   FFFFFFFFF                         F
F                                                                    FFFFFFFFFFFFFFFFFFFFFFFFFFFFFFFFFFFFFFFFFFF                                                                                          FFFFFFFFFFT  FFFFFFFFFFFF                      F
F                      f H                                           FFFFFFFFFFFFFFFFFFFFFFFFFFFFFFFFFFFFFFFFFFFF                                                                                        FFFFFFFFFFF   FFFFFFFFFFFFF                     F
F                   FFFFFFF                                          FFFFFFFFFFFFFFFFFFFFFFFFFFFFFFFFFFFFFFFFFFFF                                                                                      FFFFFFFFFFFFFV  FFFFFFFFFFFFFFFFF                 F
F                 FFFFFFFFFF                                        FFFFFFFFFFFFFFFFFFFFFFFFFFFFFFFFFFFFFFFFFFFFFFF                                                                                  FFFFFFFFFFFFFFF   FFFFFFFFFFFFFFFFFF                F
F                FFFFFFFFFFFFF                                      FFFFFFFFFFFFFFFFFFFFFFFFFFFFFFFFFFFFFFFFFFFFFFF                                                                                 FFFFFFFFFFFFFFFF   FFFFFFFFFFFFFFFFFF                F
F                FFFFFFFFFFFFFFFF                                   FFFFFFFFFFFFFFFFFFFFFFFFFFFFFFFFFFFFFFFFFFFFFFF                                                                                FFFFFFFFFFFFFFFFF   FFFFFFFFFFFFFFFFFFF               F
F               FFFFFFFFFFFFFFFFFFF                                 FFFFFFFFFFFFFFFFFFFFFFFFFFFFFFFFFFFFFFFFFFFFFFFF                                                                             FFFFFFFFFFFFFF             FFFFFFFFFFFFFFFF             F
F               FFFFFFFFFFFFFFFFFFFF                              FFFFFFFFFFFFFFFFFFFFFFFFFFFFFFFFFFFFFFFFFFFFFFFFFF                                                                            FFFFFFFFFFFFFFF             FFFFFFFFFFFFFFFFFF           F
F               FFFFFFFFFFFFFFFFFFFFFFF  G                       FFFFFFFFFFFFFFFFFFFFFFFFFFFFFFFFFFFFFFFFFFFFFFFFFFFFF                                                                      H FFFFFFFFFFFFFFFFF      A      FFFFFFFFFFFFFFFFFFFF         F
F               FFFFFFFFFFFFFFFFFFFFFFFFFF                    FFFFFFFFFFFFFFFFFFFFFFFFFFFFFFFFFFFFFFFFFFFFFFFFFFFFFFFF                                                                  FFFFFFFFFFFFFFFFFFFFFFFFFFFFFFFFFFFFFFFFFFFFFFFFFFFFFFFFFF       F
F  0  1        FFFFFFFFFFFFFFFFFFFFFFFFFFF                   F     FFFFFFFFFFFFFFFFFFFFFFFFFFFFFFFFFFFFFFFFFFFFFFFFFFFFFF                                                            FFFFFFFFFFFFFFFFFFFFFFFFFFFFFFFFFFFFFFFFFFFFFFFFFFFFFFFFFFFFFF      F
F              FFFFFFFFFFF     d    e                              FFFFFFFFFFFFFFFFFFFFFFFFFFFFFFFFFFFFFFFFFFFFFFFFFFFFFFF                                  v                     FFFFFFFFFFFFFFFFFFFFFFFFFFFFFFFFFFFFFFFFFFFFFFFFFFFFFFFFFFFFFFFFF      F
F              FFFFFFFFFFF                                    B    FFFFFFFFFFFFFFFFFFFFFFFFFFFFFFFFFFFFFFFFFFFFFFFFFFFFFFF                         c  FFFFFFFFFFFF               FFFFFFFFFFFFFFFFFFFFFFFFFFFFFFFFFFFFFFFFFFFFFFFFFFFFFFFFFFFFFFFFFF      F
F            c FFFFFFFFFFF       r        Q        R     i       s FFFFFFFFFFFFFFFFFFFFFFFFFFFFFFFFFFFFFFFFFFFFFFFFFFFFFFF      c  FFFF     FFFFFFFFFFFFFFFFFFFFFFFFFFF  c   i   FFFFFFFFFFFFFFFFFFFFFFFFFFFFFFFFFFFFFFFFFFFFFFFFFFFFFFFFFFFFFFFFFF  u c F
FFFFFFFFFFFFFFFFFFFFFFFFFFFFFFFFFFFFFFFFFFFFFFFFFFFFFFFFFFFFFFFFFFFFFFFFFFFFFFFFFFFFFFFFFFFFFFFFFFFFFFFFFFFFFFFFFFFFFFFFFFFFFFFFFFFFFFFFFFFFFFFFFFFFFFFFFFFFFFFFFFFFFFFFFFFFFFFFFFFFFFFFFFFFFFFFFFFFFFFFFFFFFFFFFFFFFFFFFFFFFFFFFFFFFFFFFFFFFFFFFFFFFFFFFF