24
24
WWWWWWWWWWWWWWWWWWWWWWWW
WFFFFeFFFFFFSFFFFFFFFVFW
WFFFFFFFFFFFFFFFFFTFFFFW
WFFFFFFFFFFFFFFFWWWWWWWW
WFFFFFFFFFFFFFFFWFFFFFFF
WFFFFFFFFFFFFFFFWFFFFFFF
WFFFFFFFFFfFFFEFWFFFFFFF
WFFFFFWWWWWWWWWWWWWWWWWW
WFFFWWWFFFFFFFFFFFFFFFFW
WWFFFFFFFFFFFFFFFFFFFFFW
FWWFBFFFFFFFFFBFFFFFFFFW
FFWWWWFFFFFFMWWWWFFFFFFW
FFFFFWFFFFFFFFCFWWWFFFFW
FFFFFWFFFFFFFFCFFFFFFFWW
FFFFFWFFFFFFFFCFFFFFWWWF
WWWWWWWWWLFFFFCFFFWWWFFF
WFFFFFFCFFFFFFCFWWWFFFFF
WFFFFFFCFFFFFFWWWFFFFFFF
WFPFFFFCFFFFWWWFFFFFFFFF
WWWWWFWWWFWWWFFFFFFFFFFF
FFFWFFFWFFFWFFFFFFFFFFFF
FFFWFFFWFFFWFFFFFFFFFFFF
FFFWFFFFFBFWFFFFFFFFFFFF
FFFWWWWWWWWWFFFFFFFFFFFF