16
16
WWWWWWWWWWWWWWWW
WFFFFFFWFFFFFFFW
WFFFFFFWFFFFFTFW
WFFFFFFFFFFFFFFW
WFFFFFFFFFFFFFFW
WFFFFFFWFFFFFFFW
WFFFFFFWFFFFFFFW
WWWFFWWWWWWWFFFW
WFFFFFFFFFFWFFFW
WFFFFFFFFFFWFFFW
WFFFFFFFFFFWFFFW
WFFFFFFFFFFWFFFW
WFFFFFFFFFFWFFFW
WFFFPFFFFFFFFFFW
WFFFFFFFFFFFFFFW
WWWWWWWWWWWWWWWW
